1111111111111111111111111111111111
10000000001C000000000C000100E00001
100000000011100000000C0001000000C1
1000000000100000000011111111101111
111110000010000000000C000000001001
1000000000000000000000000000001111
10000000000C0011111111000000000001
10000000000C000000000C000000001111
11111111100C000000000C000000001111
10000000000C0000000000011111111111
111000000CC00000000000000000000001
1000000000000000000000111111111111
1000P000000C0000000000000000001111
10000000000C0000000000000000001111
10000000000C0000000000000000001111
1111111111111111111111111111111111