1111111111111
1P000E0000011
1011011111111
11000C0000001
1000C11000011
1111111111111