111111111111111
100000000000001
1111110000E0001
1100000C0000001
100000000101001
10000CCCCC00111
111000000P11111
111111111111111