1111111111
1PCCCCCCC1
10C00000E1
1C00011001
100C111001
1111111111