111111111111111111111111111111
1PCCCCCCCCCCCCCCC1CCCCCCCCCCC1
1CCCCCCCCCCCCCCCC1CCCCCCCCCC11
1CCCCCCCCCCCCCCCC1CCCCCCCCCC11
1CCCCCCCCCCCCCCCC1CCCCCCCCCC11
1CCCCCCCCCCCCCCCC1CCCCCCCCCC11
1CCCCCCCCCCCCCCCC1CCCCCCCCCC11
1CCCCCCCCCCCCCCCC1CCCCCCCCCC11
1CCCCCCCCCCCCCCCCCCCCCCCCCCC11
1CCCCCCCCCCCCCCCCCCCCCCCCCCC11
1CCCCCCCCCCCCCCCCCCCCCCCECCC11
111111111111111111111111111111