11111111111111111111111111111111
10000000001C000000000C000100E001
100000000011100000000C0001000001
10000000001000000000111111111001
100000000010000000000C0000000001
10000000000000000000000000000001
10000000000C000000000C0000000001
10000000000C000000000C0000000001
11111111100C000000000C0000000001
10000000000C00000000000111111111
1000P000000C000000000C0000000001
11111111111111111111111111111111