111111111111111111111111111111
10000CC0001C000000000C00010001
100C000000111000000C0000000001
100000000010000000001111111111
111110000010000001000C00000001
100000000000010P01000000000001
11110E000000010001111111111111
10000000000C011111000CCCCC00C1
111111111000000000000000000001
1C000000100C0000CCC00001111111
111000001CC000000000000000C001
100000001000000000000011111111
1000C00010CCC00000000C00000001
10000000000000000000C0C0000001
111111111111111111111111111111