111111111111111111111111111111
10000000001C000000000C00010001
100C00000011100000000C00010001
100000000010000000001111111111
111110000010000000000C00000001
100000000000000000000000000001
11110E000000001111111100000001
10000000000C000000000C000000C1
111111111000000000000C00000001
10000000000C000000000001111111
111000000CC000000000000000C001
100000000000000000000011111111
1000P00000CCC00000000000000001
10000000000000000000CCC0000001
111111111111111111111111111111