111111111111111111111111111111
1PCCCCCCCC1111111111CCCCCCCC11
1CCCCCCCCCCC111111CCCCCCCCCCC1
1CCCCCCCCCCCCCCCCCCCCCCCCCCCC1
11CCCCCCCCCCCCCCCCCCCCCCCCCC11
1111111111CCCCCCCCCC1111111111
1111111111CCCCCCCCCC1111111111
1111111111CCCCCCCCCC1111111111
1111111111CCCCCCCCCC1111111111
1111111111CCCCCCCCCC1111111111
11CCCCCCCCCCCCCCCCCCCCCCCCCC11
1CCCCCCCCCCCCCCCCCCCCCCCCCCCC1
1CCCCCCCCCCC111111CCCCCCCCCCC1
11CCCCCCCCC11111111CCCCCCCCCE1
111111111111111111111111111111
