11111111111111
100C0000000011
10C0C0000E0011
110C000C000011
1000000P000011
10C00000000011
11111111111111