1111111111111
1P00000000011
101101110E111
1100000C10001
1000001000001
1111111111111