11111111111111
10000000000011
111111000E0011
110C000C000011
1000000P011111
10000000000011
11111111111111