111111111111
1P000E000001
111111111111
11000C000001
111111111111