111111111111111
10010000000C001
100C01111100001
1P0011E0000C001
111100000111001
111111111111111