1111111111
1P0000CCC1
10C00000E1
1C00011001
100C10C001
1111111111