1111111111
1P0000CCE1
10C0100001
1C00100001
100C10C001
1111111111