1111111111
1P0000CCC1
10C01000E1
1C00100001
100C10C001
1111111111