111111
1PE001
100001
100001
111111