111111111111111
100000000000111
1111110000E0001
11C0010C0000001
100001000111101
10000CCCCC00111
111000000P11111
111111111111111