111111111111111111
1000000000000P0001
111111111110000011
100000CCCC00000011
1000C0000X000CC001
111111111110000001
10E000CCCC00000001
1000C0000000000101
111111111111111111