111111111111111
1000P0000000001
1111110000E0001
1100000C0000001
100010000111001
10001CCCCC00111
111000000011111
111111111111111