111111
1PE001
1000011
100001
111111