111111
1PE001
100001
100C01
111111